111111111111111
100000000000C01
101000000000001
11E00001000P001
1010011C1000011
111111111111111