111111111111111
100000000000001
100000000000001
110000000000001
100001100000011
111111111111111