111111111111111
100000000000C01
1000000000X0001
11PC00000000001
1000011C0000011
111111111111111