1111111111
1000001C01
1000001001
1PEC000001
1000011C11
1111111111