111111111111111
100000000000C01
100000000000001
11PC00000000001
1000011E0000011
111111111111110