111111111111111
100000000000C01
100000000000001
11PC00000000E01
1000011C0000011
1111111111111111