111111111111111
100000000000C01
101000000000001
11E10000000P001
1010011C0000011
111111111111111