1111111111
1000000CE1
1000000001
1PEC000001
1000011C11
1111111111