111111111111111
100000000000C01
100000000000E01
11PC00000000001
1000011C0000011
111111111111111