1111111111
1000000C01
1000000001
1PEC000001
1000011CA1
1111111111